África do Sul: Pretória (executiva) / Bloemfontein (judiciária) / Cidade do Cabo (legislativa) 
Angola: Luanda
Argélia: Argel
Benim: Porto-Novo (constitucional) / Cotonu (sede do governo)
Botswana: Gaborone 
Burkina Faso: Ouagadougou
Burundi: Bujumbura
Cabo Verde: Praia
Camarões: Yaoundé
Chade: N'Djamena
Comores: Moroni
Costa do Marfim: Yamoussoukro
Djibouti: Djibouti
Egito: Cairo
Eritreia: Asmara
Etiópia: Adis-Abeba
Gabão: Libreville
Gana: Acra
Guiné: Conacri
Guiné Equatorial: Malabo
Guiné-Bissau: Bissau
Gâmbia: Banjul
Lesoto: Maseru
Libéria: Monróvia
Líbia: Trípoli
Madagáscar: Antananarivo
Malawi: Lilongwe
Mali: Bamako
Marrocos: Rabat
Mauritânia: Nouakchott
Maurícia: Port Louis
Moçambique: Maputo
Namíbia: Windhoek
Nigéria: Abuja
Níger: Niamey
Quénia: Nairobi
República Centro-Africana: Bangui
República Democrática do Congo: Kinshasa
República do Congo: Brazzaville
Ruanda: Kigali
Senegal: Dakar
Serra Leoa: Freetown
Seychelles: Victoria
Somália: Mogadíscio
Suazilândia: Lobamba (real e legislativa) / Mbabane (administrativa)
Sudão: Cartum
Sudão do Sul: Juba
São Tomé e Príncipe: São Tomé
Tanzânia: Dar es Salaam (administrativa) / Dodoma (oficial)
Togo: Lomé
Tunísia: Tunis
Uganda: Kampala
Zâmbia: Lusaka
Zimbabwe: Harare
Canadá: Otawwa
Estados Unidos da América: Washington
México: Cidade do México
Antígua e Barbuda: Saint John's
Bahamas: Nassau
Barbados: Bridgetown
Belize: Belmopan
Costa Rica: São José
Cuba: Havana
Dominica: Roseau
El Salvador: São Salvador
Granada: Saint George's
Guatemala: Cidade da Guatemala
Haiti: Porto Príncipe
Honduras: Tegucigalpa
Jamaica: Kingston
Nicarágua: Manágua
Panamá: Cidade de Panamá
República Dominicana: São Domingos
Santa Lúcia: Castries
São Cristóvão e Nevis: Basseterre
São Vicente e Granadinas: Kingstown
Trinidad e Tobago: Porto de Espanha
Argentina: Buenos Aires
Bolívia: La Paz (sede do governo) e Sucre (constitucional)
Brasil: Brasília
Chile: Santiago
Colômbia: Bogotá
Equador: Quito
Guiana: Georgetown
Paraguai: Assunção
Peru: Lima
Suriname: Paramaribo
Uruguai: Montevidéo
Venezuela: Caracas
Afeganistão: Cabul
Arábia Saudita: Riad
Azerbaijão: Baku
Bangladesh: Dacca
Barein: Manama
Brunei: Bandar Seri Begawan
Butão: Timphu
Camboja: Phnom Penh
Cazaquistão: Astana
Catar: Doha
China: Pequim
Cingapura: Cidade de Cingapura
Coreia do Norte: Pyongyang
Coreia do Sul: Seul
Emirados Árabes Unidos: Abu Dhabi
Filipinas: Manila
Iêmen: Sana
Índia: Nova Délhi
Indonésia: Jacarta
Irã: Teerã
Iraque: Bagdá
Israel: Jerusalém
Japão: Tóquio
Jordânia: Amã
Kuwait: Cidade do Kuwait
Laos: Vietiane
Líbano: Beirute
Malásia: Kuala Lumpur
Maldivas: Male
Mianmar: Nay Puy Taw
Mongólia: Ulan Bator
Nepal: Katmandu
Omã: Mascate
Paquistão: Islamabad
Quirguistão: Bishkek
Rússia (parte asiática): Moscou
Síria: Damasco
Sri Lanka: Colombo
Tailândia: Bangcoc
Tajidquistão: Muchambe
Timor Leste: Dili
Turcomenistão: Ashkhabad
Turquia (parte asiática): Ancara
Uzbequistão: Tashkent
Vietnã: Hanói
Albânia: Tirana
Alemanha: Berlim
Andorra: Andorra la Vella
Armênia: Erevan
Áustria: Viena
Azerbaijão: Baku
Bielorrússia: Minsk
Bélgica: Bruxelas
Bósnia-Herzegovina: Sarajevo
Bulgária: Sófia
República Tcheca: Praga
Cazaquistão: Astana
Chipre: Nicósia
Croácia: Zagreb
Dinamarca: Copenhagem
Eslováquia: Bratislava
Eslovênia: Liubliana
Espanha: Madrid
Estônia: Tallinn
Finlândia: Helsinque
França: Paris
Grécia: Atenas
Geórgia: Tbilisi
Hungria: Budapeste
Irlanda: Dublin
Islândia: Reiquiavique
Itália: Roma
Letônia: Riga
Liechtenstein: Vaduz
Lituânia: Vilnius 
Luxemburgo: Luxemburgo
República da Macedônia do Norte: Skopje
Malta: Valetta
Moldávia: Chisinau
Mônaco: Monaco-Ville
Montenegro: Podgorica
Noruega: Oslo
Países Baixos: Amsterdã
Polônia: Varsóvia
Portugal: Lisboa
Reino Unido: Londres
Romênia: Bucareste
Rússia: Moscou
Turquia: Ancara
San Marino: San Marino
Sérvia: Belgrado
Suécia: Estocolmo
Suíça: Berna
Ucrânia: Kiev
Vaticano: Vaticano
Austrália: Camberra
Fiji: Suva
Ilhas Marshall: Majuro
Ilhas Salomão: Honiara
Kiribati: Taraua
Micronésia: Paliquir
Nauru: Yaren
Nova Zelândia: Wellington
Palau: Melequeoque
Papua Nova Guiné: Porto Moresby
Samoa: Apia
Tonga: Nucualofa
Tuvalu: Funafuti
Vanuatu: Porto Vila